t    c                        t;
t                             t;
t                             t;
t           s                 t;
t         s             a  d  t;
t       s           ttttttttttt;
t     s          cttTTTTTTTTTTT;
t               ttT            ;
t            kttT              ;
t           ttT                ;
t        cttT                  ;
t       ttT                    ;
t    cttT                      ;
t   ttT                        ;
ttttT                          ;