t                             c;
t                             t;
t                             t;
tttt                          t;
t  T    a                     t;
t  Tt  tt                     t;
t       T                     t;
t     l Tttt                  t;
t t        T   e              t;
t c t      Ttttt              t;
t t       t    T              t;
t c t c t c    Ttttt          t;
c t c t c t        T          t;
t c t c t c t    akTttt     d t;
t tppptppptppttttttTTTTttttttt;