tttttttttttttttttttttttttttttt;
t                            t;
t                            T;
t                            t;
t                          d T;
t                        ttttt;
t                            T;
t       e      y a    e    a t;
ttttttttttttttttttttttttt  ttT;
t                            t;
t                            T;
t                            t;
t                            T;
t                            t;